1111111111
1000000001
1000000001
1000000001
1011100001
1001000001
1001000001
1001000001
1001110001
1000010001
1000010001
1000000001
1000000101
10000001$1
1111111111
